300 300 300 300 300 300 300 300 300 300 300 300 300 300 300 300 300 300 300 300 300 300 300 300 300 300 300 300 300 300 300 300 300 300 300 300 300 300 300 300 300 300 300 300 300 300 300 300 300 300
300 300 300 300 300 300 300 300 300 300 300 300 300 300 300 300 300 300 300 300 300 300 300 300 300 300 300 300 300 300 300 300 300 300 300 300 300 300 300 300 300 300 300 300 300 300 300 300 300 300
300 300 300 300 300 300 300 300 300 300 300 300 300 300 300 300 300 300 300 300 300 300 300 300 300 300 300 300 300 300 300 300 300 300 300 300 300 300 300 300 300 300 300 300 300 300 300 300 300 300
300 300 300 300 300 300 300 300 300 300 300 300 300 300 300 300 300 300 300 300 300 300 300 300 300 300 300 300 300 300 300 300 300 300 300 300 300 300 300 300 300 300 300 300 300 300 300 300 300 300
300 300 300 300 300 300 300 300 300 300 300 300 300 300 300 300 300 300 300 300 300 300 300 300 300 300 300 300 300 300 300 300 300 300 300 300 300 300 300 300 300 300 300 300 300 300 300 300 300 300
300 300 300 300 300 300 300 300 300 300 300 300 300 300 300 300 300 300 300 300 300 300 300 300 300 300 300 300 300 300 300 300 300 300 300 300 300 300 300 300 300 300 300 300 300 300 300 300 300 300
300 300 300 300 300 300 300 300 300 300 300 300 300 300 300 300 300 300 300 300 300 300 300 300 300 300 300 300 300 300 300 300 300 300 300 300 300 300 300 300 300 300 300 300 300 300 300 300 300 300
300 300 300 300 300 300 300 300 300 300 300 300 300 300 300 300 300 300 300 300 300 300 300 300 300 300 300 300 300 300 300 300 300 300 300 300 300 300 300 300 300 300 300 300 300 300 300 300 300 300
300 300 300 300 300 300 300 300 300 300 300 300 300 300 300 300 300 300 300 300 300 300 300 300 300 300 300 300 300 300 300 300 300 300 300 300 300 300 300 300 300 300 300 300 300 300 300 300 300 300
300 300 300 300 300 300 300 300 300 300 16 1 2 0 1 2 0 1 2 0 1 2 0 1 2 0 1 2 0 1 2 0 1 2 0 1 2 0 1 18 300 300 300 300 300 300 300 300 300 300
300 300 300 300 300 300 300 300 300 300 64 21 21 21 21 21 21 21 21 21 21 21 21 21 21 21 21 78 52 21 21 21 21 21 21 21 21 21 21 65 300 300 300 300 300 300 300 300 300 300
300 300 300 300 300 300 300 300 300 300 64 21 171 171 171 171 171 21 21 171 171 171 171 171 21 21 171 171 171 171 171 21 21 171 171 171 171 171 21 65 300 300 300 300 300 300 300 300 300 300
300 300 300 300 300 300 300 300 300 300 64 21 171 171 171 171 171 21 21 171 171 171 171 171 21 21 171 171 171 171 171 21 21 171 171 171 171 171 21 65 300 300 300 300 300 300 300 300 300 300
300 300 300 300 300 300 300 300 300 300 64 21 171 171 171 171 171 21 21 171 171 171 171 171 21 21 171 171 171 171 171 21 21 171 171 171 171 171 21 65 300 300 300 300 300 300 300 300 300 300
300 300 300 300 300 300 300 300 300 300 64 21 171 171 171 171 171 21 21 171 171 171 171 171 21 21 171 171 171 171 171 21 21 171 171 171 171 171 21 65 300 300 300 300 300 300 300 300 300 300
300 300 300 300 300 300 300 300 300 300 64 21 21 21 171 21 21 21 78 52 21 171 21 21 21 21 21 21 171 21 21 21 21 21 21 171 21 21 21 65 300 300 300 300 300 300 300 300 300 300
300 300 300 300 300 300 300 300 300 300 64 171 171 171 171 171 171 171 171 171 171 171 171 171 171 171 171 171 171 171 171 171 171 171 171 171 171 171 171 65 300 300 300 300 300 300 300 300 300 300
300 300 300 300 300 300 300 300 300 300 64 171 171 171 171 171 171 171 171 171 171 171 171 171 171 171 171 171 171 171 171 171 171 171 171 171 171 171 171 65 300 300 300 300 300 300 300 300 300 300
300 300 300 300 300 300 300 300 300 300 64 171 171 171 171 171 171 171 171 171 171 171 171 171 171 171 171 171 171 171 171 171 171 171 171 171 171 171 171 65 300 300 300 300 300 300 300 300 300 300
300 300 300 300 300 300 300 300 300 300 64 171 171 171 171 171 21 21 21 21 21 21 21 21 21 21 21 21 21 21 21 21 21 21 21 21 21 21 21 65 300 300 300 300 300 300 300 300 300 300
300 300 300 300 300 300 300 300 300 300 64 171 171 171 171 171 21 171 171 171 171 171 171 171 171 171 171 171 171 171 171 171 171 171 171 21 171 171 171 65 300 300 300 300 300 300 300 300 300 300
300 300 300 300 300 300 300 300 300 300 64 171 171 171 171 171 21 171 171 171 21 171 171 21 21 21 21 21 21 78 21 21 21 171 171 78 171 171 171 65 300 300 300 300 300 300 300 300 300 300
300 300 300 300 300 300 300 300 300 300 64 171 171 171 171 171 21 171 171 171 21 171 171 21 24 171 171 171 171 171 171 171 21 171 171 21 171 21 21 65 300 300 300 300 300 300 300 300 300 300
300 300 300 300 300 300 300 300 300 300 64 171 171 171 171 171 21 171 171 171 21 171 171 21 51 171 171 21 21 21 171 171 21 171 171 171 171 171 171 65 300 300 300 300 300 300 300 300 300 300
300 300 300 300 300 300 300 300 300 300 64 171 171 171 171 171 21 21 21 21 21 171 171 171 171 171 171 21 171 171 171 171 21 171 171 171 171 21 21 65 300 300 300 300 300 300 300 300 300 300
300 300 300 300 300 300 300 300 300 300 64 171 171 171 171 171 21 95 96 94 78 171 171 171 171 171 171 21 171 171 171 171 21 21 21 171 171 21 171 65 300 300 300 300 300 300 300 300 300 300
300 300 300 300 300 300 300 300 300 300 64 171 171 171 171 171 21 116 117 115 21 171 171 21 21 21 21 21 171 21 78 21 21 171 21 171 21 21 171 65 300 300 300 300 300 300 300 300 300 300
300 300 300 300 300 300 300 300 300 300 64 171 171 171 171 171 21 189 189 189 109 171 171 21 76 96 76 21 171 21 171 171 171 171 21 78 21 171 171 65 300 300 300 300 300 300 300 300 300 300
300 300 300 300 300 300 300 300 300 300 64 171 171 171 171 171 21 171 171 171 171 171 171 21 76 117 76 108 171 171 171 171 171 171 171 171 171 171 171 65 300 300 300 300 300 300 300 300 300 300
300 300 300 300 300 300 300 300 300 300 64 171 171 171 171 171 21 171 171 171 171 171 171 21 76 76 164 171 171 171 21 21 21 171 171 171 171 171 171 65 300 300 300 300 300 300 300 300 300 300
300 300 300 300 300 300 300 300 300 300 64 171 171 171 171 171 21 21 21 21 21 21 21 4 76 76 164 171 171 171 21 171 171 171 171 171 171 21 21 65 300 300 300 300 300 300 300 300 300 300
300 300 300 300 300 300 300 300 300 300 64 171 171 171 171 171 21 171 171 21 171 171 21 25 21 21 21 21 78 21 21 171 21 78 21 171 171 21 171 65 300 300 300 300 300 300 300 300 300 300
300 300 300 300 300 300 300 300 300 300 64 171 171 171 171 171 21 171 171 21 171 171 171 171 21 171 171 171 171 171 21 171 171 171 21 171 171 21 171 65 300 300 300 300 300 300 300 300 300 300
300 300 300 300 300 300 300 300 300 300 64 171 171 171 171 171 21 171 171 21 171 171 171 171 21 171 171 21 171 171 21 171 21 21 21 21 21 21 171 65 300 300 300 300 300 300 300 300 300 300
300 300 300 300 300 300 300 300 300 300 64 171 171 171 171 171 21 171 171 171 171 171 171 171 171 171 171 21 171 171 171 171 171 171 171 171 171 21 171 65 300 300 300 300 300 300 300 300 300 300
300 300 300 300 300 300 300 300 300 300 64 171 171 171 171 171 21 171 171 21 21 21 21 171 171 21 21 21 171 171 21 171 21 78 21 21 171 21 171 65 300 300 300 300 300 300 300 300 300 300
300 300 300 300 300 300 300 300 300 300 64 171 171 171 171 171 21 171 171 171 171 171 21 171 171 21 171 21 171 171 21 171 21 171 171 171 171 171 171 65 300 300 300 300 300 300 300 300 300 300
300 300 300 300 300 300 300 300 300 300 64 171 171 171 171 171 21 21 78 21 171 171 21 21 78 21 171 21 21 78 21 171 21 21 78 21 21 21 171 65 300 300 300 300 300 300 300 300 300 300
300 300 300 300 300 300 300 300 300 300 64 171 171 171 171 171 171 171 171 171 171 171 171 171 171 171 171 21 171 171 171 171 171 171 171 171 171 21 171 65 300 300 300 300 300 300 300 300 300 300
300 300 300 300 300 300 300 300 300 300 90 21 21 21 21 21 21 21 21 21 21 21 21 21 21 21 21 21 21 21 21 21 21 21 21 21 21 21 21 91 300 300 300 300 300 300 300 300 300 300
300 300 300 300 300 300 300 300 300 300 300 300 300 300 300 300 300 300 300 300 300 300 300 300 300 300 300 300 300 300 300 300 300 300 300 300 300 300 300 300 300 300 300 300 300 300 300 300 300 300
300 300 300 300 300 300 300 300 300 300 300 300 300 300 300 300 300 300 300 300 300 300 300 300 300 300 300 300 300 300 300 300 300 300 300 300 300 300 300 300 300 300 300 300 300 300 300 300 300 300
300 300 300 300 300 300 300 300 300 300 300 300 300 300 300 300 300 300 300 300 300 300 300 300 300 300 300 300 300 300 300 300 300 300 300 300 300 300 300 300 300 300 300 300 300 300 300 300 300 300
300 300 300 300 300 300 300 300 300 300 300 300 300 300 300 300 300 300 300 300 300 300 300 300 300 300 300 300 300 300 300 300 300 300 300 300 300 300 300 300 300 300 300 300 300 300 300 300 300 300
300 300 300 300 300 300 300 300 300 300 300 300 300 300 300 300 300 300 300 300 300 300 300 300 300 300 300 300 300 300 300 300 300 300 300 300 300 300 300 300 300 300 300 300 300 300 300 300 300 300
300 300 300 300 300 300 300 300 300 300 300 300 300 300 300 300 300 300 300 300 300 300 300 300 300 300 300 300 300 300 300 300 300 300 300 300 300 300 300 300 300 300 300 300 300 300 300 300 300 300
300 300 300 300 300 300 300 300 300 300 300 300 300 300 300 300 300 300 300 300 300 300 300 300 300 300 300 300 300 300 300 300 300 300 300 300 300 300 300 300 300 300 300 300 300 300 300 300 300 300
300 300 300 300 300 300 300 300 300 300 300 300 300 300 300 300 300 300 300 300 300 300 300 300 300 300 300 300 300 300 300 300 300 300 300 300 300 300 300 300 300 300 300 300 300 300 300 300 300 300
300 300 300 300 300 300 300 300 300 300 300 300 300 300 300 300 300 300 300 300 300 300 300 300 300 300 300 300 300 300 300 300 300 300 300 300 300 300 300 300 300 300 300 300 300 300 300 300 300 300
300 300 300 300 300 300 300 300 300 300 300 300 300 300 300 300 300 300 300 300 300 300 300 300 300 300 300 300 300 300 300 300 300 300 300 300 300 300 300 300 300 300 300 300 300 300 300 300 300 300
