479 387 536 537 387 387 387 480 479 387 387 387 387 387 387 387 387 387 387 387 387 387 387 387 387 387 480 479 387 387 387 387 387 387 387 387 387 387 387 387 387 387 387 387 387 387 387 387 387 480
501 410 562 563 410 410 410 502 501 410 410 410 410 410 410 410 410 410 410 410 410 410 410 410 410 410 502 501 410 410 410 410 410 410 410 410 410 410 410 410 410 410 410 410 410 410 410 410 410 502
501 432 549 550 432 432 432 502 501 432 432 432 432 432 432 432 432 432 432 432 432 432 432 432 432 432 502 501 432 432 432 432 432 432 432 432 432 432 432 432 432 432 432 432 432 432 432 432 432 502
501 390 414 414 414 414 392 502 501 390 391 391 391 391 391 391 391 391 391 391 391 391 391 391 391 392 502 501 390 391 391 391 391 391 391 391 391 391 391 391 391 391 391 391 391 391 391 391 392 502
501 413 414 414 414 414 415 502 501 413 414 414 414 414 414 414 414 414 414 414 414 414 414 414 414 393 502 501 435 436 414 414 414 414 414 414 414 414 414 414 414 414 414 414 414 414 414 414 415 502
501 413 414 414 414 414 415 502 501 413 414 414 414 414 414 414 436 436 436 436 436 436 436 436 436 392 502 520 455 456 413 414 414 414 414 414 414 414 414 414 414 414 414 414 414 414 414 414 415 502
501 413 414 414 414 414 415 502 501 413 414 414 414 414 414 454 455 455 455 455 455 455 455 455 456 458 476 387 480 501 413 414 414 414 414 414 414 414 414 414 414 414 414 414 414 414 414 414 415 502
501 413 414 414 414 414 415 502 501 413 414 414 436 436 436 502 479 387 387 387 387 387 387 387 478 458 410 410 502 501 413 414 414 414 414 414 414 414 414 414 414 414 414 414 414 414 414 414 415 502
501 413 414 414 414 414 415 502 501 413 414 415 454 455 455 521 501 410 410 410 410 410 410 410 500 458 432 432 502 501 413 414 414 414 414 414 414 414 414 414 414 414 414 414 414 414 414 414 415 502
501 413 414 414 414 414 415 502 501 413 414 415 476 387 387 477 478 432 432 432 432 432 432 432 519 390 414 392 502 501 413 414 414 414 414 414 414 414 414 414 414 414 414 414 414 414 414 414 415 502
501 413 414 414 414 414 415 502 501 413 414 415 410 410 499 499 500 390 391 391 391 391 391 391 391 414 414 415 502 501 413 414 414 414 414 414 414 414 414 414 414 414 414 414 414 414 414 414 415 502
501 413 414 414 414 414 415 502 501 413 414 415 432 432 432 432 519 413 414 414 414 414 414 414 414 414 414 415 502 501 413 414 414 414 414 414 414 414 414 414 414 414 414 414 414 414 414 414 415 502
501 413 414 414 414 414 415 502 501 413 414 415 458 458 458 458 458 413 414 414 414 414 414 414 414 414 414 415 502 501 413 414 414 414 414 414 414 414 414 414 414 414 414 414 414 414 414 414 415 502
501 413 414 414 414 414 415 502 501 413 414 415 454 455 455 455 456 413 414 414 414 414 414 436 436 436 436 437 502 501 413 414 414 414 414 414 414 414 414 414 414 414 414 414 414 414 414 414 415 502
501 413 414 414 414 414 415 502 501 413 414 415 476 480 479 480 501 413 414 414 414 414 414 454 455 455 455 455 521 501 413 414 414 414 414 414 414 414 414 414 414 414 414 414 414 414 414 414 415 502
501 413 414 414 414 414 415 502 501 413 414 414 392 502 501 502 501 435 436 436 436 436 414 502 479 387 387 387 387 478 435 436 436 436 436 436 436 414 414 414 414 414 414 414 414 414 414 414 415 502
501 413 414 414 414 414 415 502 501 413 414 414 415 502 501 502 520 455 455 455 455 456 414 502 520 455 455 455 455 455 455 455 455 455 455 455 456 413 414 414 414 414 414 414 414 414 414 414 415 502
501 413 414 414 414 414 415 502 501 435 436 436 437 502 501 502 178 177 181 479 387 478 458 476 387 387 387 387 387 387 387 387 387 387 387 480 501 413 414 414 414 414 414 414 414 414 414 414 415 502
501 413 414 414 414 414 415 502 520 455 455 455 455 521 501 502 203 179 206 501 410 410 458 410 410 410 410 410 410 410 410 410 410 410 410 502 501 413 414 414 414 414 414 414 414 414 414 414 415 502
501 413 414 414 414 414 415 476 387 387 387 387 387 387 478 502 203 1 181 501 432 432 458 432 432 432 432 432 432 432 432 432 432 432 432 502 501 435 436 436 436 436 436 436 436 436 436 436 437 502
501 413 414 414 414 414 415 410 454 455 455 455 455 455 455 521 203 207 208 501 390 391 391 391 391 391 391 391 391 391 391 391 391 391 392 502 520 455 455 455 455 455 455 455 455 455 455 455 455 521
501 413 414 414 414 414 415 432 476 387 387 387 387 387 387 387 387 477 477 478 413 414 414 414 414 414 414 414 414 414 414 414 414 414 415 502 479 387 387 387 387 387 538 539 387 387 387 387 387 480
501 413 414 414 414 414 414 415 410 499 499 499 499 499 499 499 499 499 499 500 413 414 414 414 414 414 414 414 414 414 414 414 414 414 415 502 501 499 499 499 499 499 564 565 499 499 499 499 499 502
501 413 414 414 414 414 414 415 432 432 432 432 432 432 432 432 432 432 432 519 413 414 414 414 414 414 414 414 414 414 414 414 414 414 415 502 501 432 432 432 432 432 551 552 432 432 432 432 432 502
501 435 436 436 436 436 436 437 458 458 458 458 458 458 458 458 458 458 458 458 413 414 414 414 414 414 414 414 414 414 414 414 414 414 415 502 501 390 391 391 391 391 414 414 391 391 391 391 392 502
520 455 455 455 455 455 455 455 455 455 455 455 455 455 455 455 455 455 455 456 413 414 414 414 414 414 414 414 414 414 414 414 414 414 415 476 478 413 414 414 414 414 414 414 414 414 414 414 415 502
479 387 387 387 387 387 387 387 387 387 387 387 387 387 387 387 387 387 387 478 413 414 414 414 414 414 414 414 414 414 414 414 414 414 415 410 500 413 414 436 436 414 414 414 414 414 414 414 415 502
501 499 499 499 499 499 499 499 499 499 499 499 499 499 499 499 499 499 499 500 413 414 414 414 414 414 414 414 414 414 414 414 414 414 415 432 519 413 415 454 456 413 414 414 414 414 414 414 415 502
501 432 432 432 432 432 432 432 432 432 432 432 432 432 432 432 432 432 432 519 413 414 414 414 414 414 414 414 414 414 414 414 414 414 415 458 458 413 415 502 501 413 414 414 414 414 414 414 415 502
501 390 458 458 458 458 458 458 458 458 458 458 458 458 458 458 458 458 458 458 435 436 436 436 436 436 436 436 436 436 436 436 436 436 437 454 456 413 415 502 501 413 414 414 414 414 414 414 415 502
501 413 415 454 455 455 455 455 455 455 455 455 455 455 455 455 455 455 455 455 455 455 455 455 455 455 455 455 455 455 455 455 455 455 455 521 501 413 415 502 501 413 414 414 414 414 414 414 415 502
501 413 415 476 387 387 387 387 387 387 387 387 387 387 387 387 387 387 387 387 387 387 387 387 387 387 387 387 387 480 479 387 387 387 387 387 478 413 415 502 501 413 414 414 414 414 414 414 415 502
501 413 415 410 499 499 499 499 499 499 499 499 499 499 499 499 499 499 410 410 410 410 410 410 410 410 410 410 410 502 501 500 500 500 500 500 500 413 415 502 501 413 414 414 414 414 414 414 415 502
501 413 415 432 432 432 432 432 432 432 432 432 432 432 432 432 432 432 432 432 432 432 432 432 432 432 432 454 455 521 501 519 519 519 519 519 519 414 415 502 501 413 414 414 414 414 414 414 415 502
501 413 415 391 391 391 391 391 391 391 391 391 458 458 458 458 458 458 391 391 391 391 391 391 391 391 458 502 479 477 478 390 391 391 391 391 391 414 415 502 501 413 414 414 414 414 414 414 415 502
501 413 414 414 414 414 414 414 415 454 455 455 455 455 455 455 455 455 455 456 414 414 414 414 414 454 455 521 501 499 500 414 414 414 414 414 414 414 415 502 501 413 414 414 414 414 414 414 415 502
501 413 414 414 414 414 414 414 415 502 479 387 387 387 387 387 387 387 387 478 414 414 414 414 437 502 479 477 478 432 519 414 414 414 414 414 414 414 437 502 501 413 414 414 414 414 414 414 415 502
501 413 414 414 414 414 414 414 415 502 501 499 499 499 499 499 499 499 499 500 414 414 414 454 455 521 501 499 500 390 414 414 414 454 455 455 455 455 455 521 520 455 455 455 455 455 455 455 455 521
501 413 414 414 414 414 414 414 415 502 501 432 432 432 432 432 432 432 432 519 414 414 437 502 479 477 478 432 519 414 414 414 437 502 479 477 477 477 477 477 477 387 387 387 387 387 387 387 387 480
501 413 414 414 414 414 414 414 415 502 501 390 391 391 391 391 391 391 391 391 414 454 455 521 501 499 500 390 414 414 414 454 455 521 501 499 499 499 499 499 499 499 499 499 499 499 499 499 499 502
501 413 414 436 436 436 436 436 437 502 501 413 436 436 436 436 436 436 436 436 437 502 479 477 478 432 519 414 414 414 437 502 479 477 478 432 432 432 432 432 432 432 432 432 432 432 432 432 432 502
501 413 414 454 455 455 455 455 455 521 520 455 455 455 455 455 455 455 455 455 455 521 501 499 500 390 414 414 414 454 455 521 501 499 500 390 391 391 391 391 391 391 391 391 391 391 391 391 392 502
501 413 414 476 387 387 387 387 387 480 479 387 387 387 387 387 387 387 387 387 387 477 478 432 519 414 436 436 437 502 479 477 478 432 519 414 414 414 414 414 414 414 414 414 414 414 414 414 415 502
501 413 414 410 499 499 499 499 499 502 501 499 499 499 499 499 499 499 499 499 410 499 500 390 414 415 454 455 455 521 501 499 500 390 391 414 414 414 414 414 414 414 414 414 414 414 414 414 415 502
501 413 414 432 432 432 432 432 432 502 501 432 432 432 432 432 432 432 432 432 432 432 519 414 414 415 502 479 477 477 478 432 519 414 414 414 414 414 414 414 414 414 414 414 414 414 414 414 415 502
501 413 414 391 391 391 391 391 392 502 501 390 391 391 391 391 391 391 391 391 391 391 391 414 414 415 502 501 499 499 500 390 391 414 414 414 414 414 414 414 414 414 414 414 414 414 414 414 415 502
501 413 414 414 414 414 414 414 415 502 501 413 414 414 414 454 456 414 414 414 414 414 414 414 414 415 502 501 432 432 519 414 414 414 414 414 414 414 414 414 414 414 414 414 414 414 414 414 415 502
501 413 414 414 414 414 414 414 415 502 501 413 414 414 414 502 501 414 414 414 414 414 414 414 414 415 502 501 390 391 391 414 414 414 414 414 414 414 414 414 414 414 414 414 414 414 414 414 415 502
501 435 436 436 436 436 436 436 437 502 501 435 436 436 437 502 501 435 436 436 436 436 436 436 436 437 502 501 435 436 436 436 436 436 436 436 436 436 436 436 436 436 436 436 436 436 436 436 437 502
520 455 455 455 455 455 455 455 455 521 520 455 455 455 455 521 520 455 455 455 455 455 455 455 455 455 521 520 455 455 455 455 455 455 455 455 455 455 455 455 455 455 455 455 455 455 455 455 455 521