315 104 43 44 105 67 321 342 342 342 342 342 342 342 342 342 342 342 342 342 342 342 342 342 342 342 342 342 342 342 342 342 342 342 342 342 342 342 342 342 342 342 342 342 342 342 342 342 342 320
53 53 69 70 53 53 334 354 354 354 354 321 330 330 330 330 330 330 330 330 330 331 354 354 354 354 354 354 354 354 354 354 354 354 354 354 354 354 354 354 354 354 354 354 354 354 354 354 354 334
324 354 369 362 362 370 334 354 354 354 321 326 329 330 330 330 330 330 330 330 331 325 331 354 354 354 354 354 354 354 354 354 354 354 354 354 354 354 354 354 354 354 354 354 354 354 354 354 354 334
335 354 355 366 366 353 341 320 354 321 326 354 334 354 354 354 354 354 354 354 328 354 325 331 354 354 354 354 354 354 354 354 354 354 354 354 354 354 354 354 354 354 354 354 354 354 354 354 354 334
335 354 377 347 366 361 370 341 320 341 320 354 334 354 354 354 329 330 324 354 317 354 354 328 354 354 354 354 354 354 354 354 354 354 354 354 354 354 354 354 354 354 354 354 354 354 354 354 354 334
335 354 354 355 366 366 353 354 334 354 341 320 341 342 342 342 342 342 343 354 317 354 354 317 354 354 354 354 354 354 354 354 354 354 354 354 354 354 354 354 354 354 354 354 354 354 354 354 354 334
335 354 354 377 347 366 361 370 341 320 354 341 320 341 320 354 354 354 354 354 333 354 354 333 354 354 319 342 342 342 337 316 316 316 316 316 338 342 320 354 354 354 354 354 354 354 354 354 354 334
335 354 354 354 355 366 366 361 370 341 320 354 341 320 341 342 342 342 342 342 343 319 342 344 319 342 343 369 362 362 362 362 362 362 362 362 362 370 341 342 342 320 354 354 354 354 354 354 354 334
335 354 354 354 377 347 366 366 361 370 341 320 354 341 342 342 342 342 342 342 342 344 319 342 343 369 362 363 366 366 366 366 366 366 366 366 366 361 362 362 370 341 320 354 354 354 354 354 354 334
335 354 354 354 354 377 346 347 366 361 370 341 342 342 342 342 342 342 342 342 342 342 343 369 362 363 366 366 345 346 346 346 346 346 346 346 347 366 366 366 361 370 334 354 354 354 354 354 354 334
335 321 318 318 318 318 324 377 347 366 361 362 362 362 362 362 362 362 362 362 362 362 362 363 366 366 345 346 354 319 342 342 342 342 342 320 377 346 347 366 366 353 334 354 354 354 354 354 354 334
335 369 362 362 362 370 325 324 377 347 366 366 366 366 366 366 366 366 366 366 366 366 366 345 346 346 354 319 342 343 354 354 354 354 354 334 354 354 377 347 366 353 334 354 354 354 354 354 354 334
335 377 346 346 346 378 354 325 324 377 346 346 347 366 371 346 346 346 346 346 346 346 346 378 354 354 319 343 354 354 354 354 354 354 354 341 320 354 354 355 366 353 341 320 354 354 354 354 354 334
335 354 329 330 330 330 331 354 325 318 318 324 355 366 361 370 354 354 319 342 342 342 320 354 319 342 343 354 354 354 354 354 354 354 354 354 334 354 354 355 366 361 370 341 320 354 354 354 354 334
335 329 326 329 330 331 325 331 354 369 370 328 377 347 366 353 354 319 343 354 354 354 341 342 343 354 354 354 354 319 342 320 354 354 354 354 341 320 354 377 347 366 353 354 341 320 354 354 354 334
333 334 354 334 354 317 354 335 354 355 353 317 369 363 345 378 354 335 354 319 320 354 354 354 354 354 354 319 342 343 354 334 354 354 354 354 354 334 354 354 355 366 353 354 354 341 342 342 320 334
335 341 320 341 342 343 354 335 354 355 353 317 355 366 353 354 319 343 319 343 341 337 316 316 338 342 342 343 354 354 354 341 320 354 354 354 354 341 320 354 355 366 353 354 329 330 330 330 326 334
335 354 336 337 316 316 338 339 369 363 353 317 355 366 353 354 335 319 343 354 354 318 318 318 318 354 354 354 354 354 354 354 334 354 354 354 354 354 334 354 355 366 361 370 334 354 354 354 354 334
335 354 369 362 362 362 362 362 363 366 353 317 355 366 353 354 335 343 341 320 354 354 354 354 354 354 354 354 354 354 354 354 341 342 342 320 354 354 334 354 377 347 366 353 334 354 354 354 354 334
335 354 355 366 366 366 366 366 366 345 378 333 377 346 354 319 343 354 354 341 320 354 354 354 354 319 342 320 354 354 354 354 354 354 354 341 320 354 341 320 354 355 366 353 334 354 354 354 354 334
335 369 363 345 346 346 346 347 345 378 319 339 354 319 342 343 354 354 354 354 341 337 316 316 338 343 354 334 354 354 354 354 354 354 354 354 334 354 354 334 354 355 366 353 341 320 354 354 354 334
335 377 346 378 319 342 320 377 378 319 339 354 319 343 354 354 354 354 354 354 354 354 354 354 354 354 354 341 320 354 354 354 354 354 354 354 334 354 354 334 354 355 366 361 370 334 354 354 354 334
335 354 319 342 339 354 336 320 319 339 354 319 343 354 354 354 354 354 354 354 354 354 354 354 354 354 354 354 341 342 342 342 320 354 354 354 334 354 354 334 354 355 366 366 353 334 354 354 354 334
335 354 335 354 354 354 354 336 339 354 319 343 354 354 354 354 354 354 354 354 354 354 354 354 354 354 354 354 354 354 354 354 341 320 354 354 334 354 354 334 354 377 347 366 353 334 354 354 354 334
335 319 340 354 354 354 354 354 319 342 343 354 354 354 354 354 354 354 354 354 354 354 354 354 354 354 354 354 354 354 354 354 354 334 354 354 334 354 354 334 354 354 355 366 353 334 354 354 354 334
335 339 354 354 354 319 342 342 343 324 354 354 354 354 354 354 354 354 354 354 354 329 330 330 330 330 330 330 330 330 324 354 354 334 354 354 334 354 354 341 320 354 355 366 353 334 354 354 354 334
335 354 354 354 354 328 354 354 354 325 324 354 354 354 354 354 354 354 354 354 354 334 329 330 330 330 330 330 330 324 335 354 354 334 354 354 334 354 354 354 334 354 355 366 353 334 354 354 354 334
335 354 354 354 354 317 354 354 354 354 325 324 354 354 354 354 354 354 354 354 354 327 327 354 354 354 354 354 354 335 335 354 354 334 354 354 334 354 354 354 334 354 355 366 353 334 354 354 354 334
335 354 354 354 354 317 354 354 354 354 354 335 354 354 354 354 354 354 354 354 354 315 315 354 354 354 354 354 354 335 335 354 354 334 354 354 334 354 354 329 326 354 355 366 353 341 320 354 354 334
335 354 354 354 354 317 354 354 354 354 354 335 354 354 354 354 354 354 354 354 354 332 332 354 354 354 354 354 354 335 335 354 329 326 354 354 334 354 329 326 354 354 355 366 353 354 334 354 354 334
335 354 354 354 354 333 354 354 354 354 354 325 324 354 354 354 354 354 354 354 354 334 334 354 354 354 354 354 354 335 335 354 334 354 354 354 334 354 334 354 354 354 355 366 353 354 334 354 354 334
335 324 354 354 354 335 354 354 354 354 354 354 325 330 330 324 354 354 354 354 354 334 336 342 342 342 342 342 342 344 335 329 326 354 354 329 326 354 334 354 354 354 355 366 353 354 334 354 354 334
335 325 324 354 354 325 324 354 354 354 354 354 354 354 354 325 330 324 354 354 354 336 342 342 342 342 342 342 342 342 344 334 354 354 354 334 354 354 334 354 354 354 355 366 353 354 334 354 354 334
335 354 335 354 354 354 325 330 330 330 330 324 354 354 354 354 354 325 330 330 330 330 324 354 354 354 354 354 354 354 329 326 354 354 354 334 354 354 334 354 354 354 355 366 353 354 334 354 354 334
335 354 335 354 354 369 362 362 362 362 370 325 330 324 354 354 354 354 354 354 354 354 325 330 324 354 354 354 354 329 326 354 354 354 329 326 354 329 326 354 354 369 363 366 353 354 334 354 354 334
335 354 335 354 369 363 366 366 366 366 361 362 370 325 330 324 354 354 354 354 354 354 354 354 325 324 354 354 329 326 354 354 354 329 326 354 329 326 354 354 354 355 366 366 353 354 334 354 354 334
335 354 335 354 355 366 366 345 347 366 366 366 361 362 370 325 330 324 354 354 354 354 354 354 354 325 330 330 326 354 354 354 329 326 354 329 326 354 354 354 354 355 366 345 378 354 341 320 354 334
335 354 325 324 377 346 346 378 377 346 347 366 366 366 361 362 370 325 330 324 354 354 354 354 354 354 354 354 354 354 354 354 334 354 329 326 354 354 354 354 369 363 366 353 354 354 354 334 354 334
335 354 354 325 330 330 330 330 330 324 377 346 347 366 366 366 361 362 370 325 330 324 354 354 354 354 354 354 354 354 354 329 330 330 326 354 354 354 354 354 355 366 366 353 354 354 354 334 354 334
335 354 354 354 354 354 354 354 354 325 324 354 377 346 347 366 366 366 361 370 354 325 330 324 354 354 354 354 354 354 329 326 354 354 354 354 354 354 354 354 355 366 345 378 354 354 354 334 354 334
335 354 354 354 354 354 354 354 354 354 325 324 354 354 377 346 347 366 366 361 362 370 354 325 330 330 330 330 330 330 326 354 354 354 354 354 354 354 354 369 363 366 353 354 354 354 354 334 354 334
335 354 354 354 354 354 354 354 354 354 354 325 324 354 354 354 377 347 366 366 366 361 370 354 354 354 354 354 354 354 354 354 354 354 354 354 354 354 369 363 366 366 353 354 354 354 329 326 354 334
335 354 354 354 354 354 354 354 354 354 354 354 325 324 354 354 354 377 346 347 366 366 361 362 370 354 354 354 354 354 354 354 354 354 354 354 354 369 363 366 366 345 378 354 354 354 334 354 354 334
335 354 354 354 354 354 354 354 354 354 354 354 354 335 354 354 354 329 324 377 347 366 366 366 361 362 362 362 370 354 354 354 369 362 362 362 362 363 366 366 345 378 354 354 354 354 334 354 354 334
335 354 354 354 354 354 354 354 354 354 354 354 354 325 330 330 330 326 325 324 377 346 346 346 347 366 366 366 361 362 362 362 363 366 366 366 366 366 345 346 378 354 354 354 354 354 334 354 354 334
335 354 354 354 354 354 354 354 354 354 354 354 354 354 354 354 354 354 354 325 330 330 330 324 377 346 347 366 366 366 366 366 366 366 345 346 346 346 378 354 354 354 354 354 354 329 326 354 354 334
335 354 354 354 354 354 354 354 354 354 354 354 354 354 354 354 354 354 354 354 354 354 354 325 330 324 377 346 346 346 346 346 346 346 378 354 354 354 354 354 354 354 354 354 329 326 354 354 354 334
335 354 354 354 354 354 354 354 354 354 354 354 354 354 354 354 354 354 354 354 354 354 354 354 354 325 330 330 330 330 330 330 330 330 330 330 330 330 330 330 330 324 354 329 326 354 354 354 354 334
335 354 354 354 354 354 354 354 354 354 354 354 354 354 354 354 354 354 354 354 354 354 354 354 354 354 354 354 354 354 354 354 354 354 354 354 354 354 354 354 354 325 330 326 354 354 354 354 354 334
325 330 330 330 330 330 330 330 330 330 330 330 330 330 330 330 330 330 330 330 330 330 330 330 330 330 330 330 330 330 330 330 330 330 330 330 330 330 330 330 330 330 330 330 330 330 330 330 330 326
